{ "properties" : {"id" : 0, "name" : "debug map", "sprite" : "textures/spritesheets/tileMap/tileSheet_0.atlas"},
  "map_0" : {
    "width" : 12, "height": 12,
    "data" : [0, 0, 0, 0, 0, 0, 0, 0, 0, 0, 0, 0,
              1, 1, 1, 1, 1, 1, 1, 1, 1, 1, 1, 1,
              0, 0, 0, 0, 0, 0, 0, 0, 0, 0, 0, 0,
              0, 0, 0, 0, 0, 0, 0, 0, 0, 0, 0, 0,
              0, 0, 0, 0, 0, 0, 0, 0, 0, 0, 0, 1,
              0, 0, 0, 0, 0, 0, 0, 0, 0, 0, 0, 1,
              0, 0, 0, 0, 0, 0, 0, 0, 0, 0, 0, 1,
              0, 0, 1, 1, 1, 1, 0, 0, 0, 0, 0, 2,
              0, 0, 0, 0, 0, 0, 0, 0, 0, 0, 0, 2,
              0, 0, 0, 0, 0, 0, 0, 0, 0, 0, 0, 2,
              0, 0, 1, 1, 1, 1, 0, 0, 0, 0, 0, 2,
              1, 1, 2, 2, 2, 2, 1, 1, 1, 1, 1, 2],
  "entities" : [
    {"player" : {"position" : [0, 1], "sprite" : "textures/blue_penguin_64x80.png"}}]},
  "map_1" : {
    "properties" : {"width" : 12, "height": 12},
    "data" : [2, 2, 2, 2, 2, 2, 2, 2, 2, 2, 2, 2,
              1, 1, 2, 2, 2, 2, 1, 1, 1, 1, 1, 2,
              0, 0, 1, 1, 1, 1, 0, 0, 0, 0, 0, 2,
              0, 0, 0, 0, 0, 0, 0, 0, 0, 0, 0, 2,
              0, 0, 0, 0, 0, 0, 0, 0, 0, 0, 0, 0,
              0, 0, 0, 1, 0, 0, 0, 0, 0, 0, 0, 0,
              0, 0, 1, 2, 0, 0, 0, 0, 0, 0, 0, 0,
              1, 1, 2, 2, 0, 0, 0, 0, 0, 0, 0, 0,
              2, 2, 2, 2, 0, 0, 0, 0, 0, 0, 0, 0,
              2, 2, 2, 2, 0, 0, 1, 1, 0, 0, 0, 0,
              2, 2, 2, 2, 0, 0, 2, 2, 1, 0, 0, 0,
              2, 2, 2, 2, 0, 0, 2, 2, 2, 1, 1, 1],
  "entities" : [
    {"player" : {"position" : [0, 5], "sprite" :  "textures/red_penguin_64x80.png"}}],
  }
}