{ "properties" : {"id" : 0, "name" : "debug map"},
  "map_0" : {"width" : 12, "height": 12,
    "data" : [0, 0, 0, 0, 0, 0, 0, 0, 0, 0, 0, 0,
              1, 1, 1, 1, 1, 1, 1, 1, 1, 1, 1, 1,
              0, 0, 0, 0, 0, 0, 0, 0, 0, 0, 0, 0,
              0, 0, 0, 0, 0, 0, 0, 0, 0, 0, 0, 0,
              0, 0, 0, 0, 0, 0, 0, 0, 0, 0, 0, 1,
              0, 0, 0, 0, 0, 0, 0, 0, 0, 0, 0, 1,
              0, 0, 0, 0, 0, 0, 0, 0, 0, 0, 0, 1,
              0, 0, 1, 1, 1, 1, 0, 0, 0, 0, 0, 1,
              0, 0, 0, 0, 0, 0, 0, 0, 0, 0, 0, 1,
              0, 0, 0, 0, 0, 0, 0, 0, 0, 0, 0, 1,
              0, 0, 0, 0, 0, 0, 0, 0, 0, 0, 0, 1,
              1, 1, 1, 1, 1, 1, 1, 1, 1, 1, 1, 1]},
  "map_1" : {"width" : 3, "height": 3,
    "data" : [0, 0, 0,
              1, 1, 1,
              1, 1, 1]}
}